1111111111111111111111
10010E0000100000010001
100000111111000C100001
10001111C0000111111101
1000P11100000000110001
1111111111111111111111
