1111111111111111111111
10010E0000110000000101
10000011000000C1000001
10001111C00001111111C1
1000P1110CC0000110C001
1111111111111111111111