11111111
1P000C01
11111111
10C11101
10100001
11101111
1C0000E1
11111111