11111111
1P000001
10111101
10011101
10100001
11101111
100000E1
11111111