111111111111111111111
1000000C00000000C0001
100000001110000000001
100000000110000011001
100000111000000000001
1000000000000C0000001
100000E00000000011001
100110000000011100001
1000000000000000C0001
111111111111111111111