11111111
1P000C01
10111101
10C11100
10100000
11101111
1C0000E0
11111111